1,1,1,0,0,0,2,0,2,0,0,0,1,1,1
1,1,0,0,0,0,2,0,2,0,0,0,0,1,1
1,0,0,0,0,0,2,0,2,0,0,0,0,0,1
1,0,0,0,0,1,1,1,1,1,0,0,0,0,1
0,0,0,0,1,1,0,0,0,1,1,0,0,0,0
2,2,2,2,1,0,2,0,2,0,1,2,2,2,2
0,0,0,0,1,0,0,2,0,0,1,0,0,0,0
2,2,2,2,1,0,2,0,2,0,1,2,2,2,2
0,0,0,0,1,1,0,0,0,1,1,0,0,0,0
1,0,0,0,0,1,1,1,1,1,0,0,0,0,1
1,0,0,0,0,0,2,0,2,0,0,0,0,0,1
1,1,0,0,0,0,2,0,2,0,0,0,0,1,1
1,1,1,0,0,0,2,0,2,0,0,0,1,1,1
5,5,3,5,4,5,5,4,5,5,4,5,5,5,5
5,5,5,5,4,5,3,4,3,5,4,5,5,5,5
3,5,-1,3,5,5,5,3,5,5,5,3,-1,5,3
5,5,3,5,4,5,5,4,5,5,4,5,3,5,5
5,5,5,5,5,5,3,4,3,5,5,5,5,5,5
5,5,3,5,5,3,5,5,5,3,5,5,3,5,5
4,4,5,3,4,3,5,5,5,3,4,3,5,4,4
5,5,3,5,5,3,5,5,5,3,5,5,3,5,5
5,5,5,5,5,5,3,4,3,5,5,5,5,5,5
5,5,3,5,4,5,5,4,5,5,4,5,3,5,5
3,5,-1,3,5,5,5,3,5,5,5,3,-1,5,3
5,5,5,5,4,5,3,4,3,5,4,5,5,5,5
5,5,3,5,4,5,5,4,5,5,4,5,3,5,5
