0,0,2,0,0,1,0,0,0,2,0,0,1,0,0
0,1,0,0,2,0,0,1,0,0,2,0,0,0,0
2,0,0,1,0,0,2,0,0,1,0,0,2,0,0
0,0,1,0,0,2,0,0,1,0,0,2,0,0,1
0,2,0,0,1,0,0,2,0,0,1,0,0,2,0
0,0,0,1,0,0,2,0,0,1,0,0,2,0,0
1,0,0,0,2,0,0,1,0,0,2,0,0,1,0
0,2,0,0,1,0,0,2,0,0,1,0,0,2,0
0,0,1,0,0,2,0,0,1,0,0,2,0,0,1
2,0,0,2,0,0,1,0,0,2,0,0,1,0,0
0,1,0,0,2,0,0,1,0,0,2,0,0,0,0
0,0,2,0,0,1,0,0,0,2,0,0,1,0,0
0,2,0,0,1,0,0,2,0,0,1,0,0,2,0
5,5,5,5,5,5,3,5,5,5,5,4,5,5,5
5,5,4,5,5,5,5,5,5,5,3,5,5,5,5
5,5,-1,5,5,3,5,5,4,5,5,5,5,5,5
5,3,5,5,5,5,5,5,5,5,5,4,5,5,5
5,5,5,5,4,5,5,5,5,3,5,5,5,5,5
4,5,5,5,5,-1,5,5,5,5,5,5,3,5,5
5,5,5,4,5,5,5,5,3,5,5,5,5,5,5
5,5,5,5,5,5,4,5,5,5,5,5,5,3,5
3,5,5,5,5,5,5,5,5,4,5,5,5,5,5
5,5,5,5,5,5,5,3,5,5,-1,5,5,5,4
5,5,5,5,4,5,5,5,5,5,3,5,5,5,5
5,3,5,5,5,5,5,5,5,5,5,5,4,5,5
5,-1,5,4,5,5,5,5,5,5,5,3,5,5,5
